30 30 30 30 30 30 30 30 30 30 30 30 30 30 30 30 30 30 30 30 30 30 30 30 30 30 30 30 30 30 30 30 30 30 30 30 30 30 30 30 30 30 30 30 30 30 30 30 30 30 30 30 30 30 30 30 30 30 30 30
30 30 30 30 30 30 30 30 30 30 30 30 30 30 30 30 30 30 30 30 30 30 30 30 30 30 30 30 30 30 30 30 30 30 30 30 30 30 30 30 30 30 30 30 30 30 30 30 30 30 30 30 30 30 30 30 30 30 30 30
30 30 30 30 30 30 30 30 30 30 30 30 30 30 30 30 30 30 30 30 30 30 30 30 30 30 30 30 30 30 30 30 30 30 30 30 30 30 30 30 30 30 30 30 30 30 30 30 30 30 30 30 30 30 30 30 30 30 30 30
30 30 30 30 30 30 30 30 30 30 30 30 30 30 30 30 30 30 30 30 30 30 30 30 30 30 30 30 30 30 30 30 30 30 30 30 30 30 30 30 30 30 30 30 30 30 30 30 30 30 30 30 30 30 30 30 30 30 30 30
30 30 30 30 30 30 30 30 35 32 32 32 32 32 32 32 32 36 30 30 30 30 30 35 32 32 32 32 32 32 32 32 32 32 32 32 32 32 32 32 32 32 32 32 32 32 32 32 32 32 32 32 32 32 36 30 30 30 30 30
30 30 30 30 30 30 35 32 42 22 25 23 17 19 24 12 11 20 36 30 30 30 35 23 20 21 22 22 22 23 24 14 25 20 23 14 17 23 23 10 23 20 21 20 23 21 20 23 24 24 22 24 21 19 33 30 30 30 30 30
30 30 30 30 30 30 34 23 20 24 22 21 22 20 23 20 24 22 23 36 30 30 34 24 22 21 22 20 22 24 24 23 20 24 23 24 24 24 20 20 22 21 21 22 24 24 24 24 20 22 20 23 24 20 33 30 30 30 30 30
30 30 30 30 30 30 34 21 21 23 15 27 21 23 23 23 10 69 10 33 30 30 34 18 12 15 11 13 14 10 12 11 21 23 12 12 12 11 14 20 24 23 22 22 21 23 24 12 11 12 15 20 22 23 33 30 30 30 30 30
30 30 30 30 30 30 34 24 11 12 13 13 17 20 21 23 71 63 70 33 30 30 34 10 69 13 15 24 24 10 59 56 56 56 56 56 56 56 56 56 56 56 56 56 56 56 60 13 14 10 69 13 23 10 33 30 30 30 30 30
30 30 30 30 30 30 34 23 19 22 14 12 12 16 20 17 71 63 70 33 30 30 34 71 63 70 17 21 23 19 58 50 50 50 50 50 50 50 50 50 50 50 50 50 50 50 57 14 23 71 63 70 20 10 33 30 30 30 30 30
30 30 30 30 30 30 34 20 17 24 11 13 19 18 23 19 71 63 70 33 30 30 34 71 63 70 12 22 22 23 58 50 50 50 50 50 50 50 50 50 50 50 50 50 50 50 57 21 23 71 63 70 20 20 33 30 30 30 30 30
30 30 30 30 30 30 34 21 16 21 22 19 18 16 21 22 71 63 70 33 30 30 34 71 63 70 22 17 23 24 58 50 50 50 50 50 50 50 50 50 50 50 50 50 50 50 57 22 20 71 63 70 22 16 33 30 30 30 30 30
30 30 30 30 30 30 34 23 17 15 21 23 12 24 23 22 71 63 70 33 30 30 34 71 63 70 21 22 25 11 58 50 50 50 50 51 55 55 55 55 55 55 52 50 50 50 57 22 23 71 63 70 22 17 33 30 30 30 30 30
30 30 30 30 30 30 34 22 23 16 22 22 11 23 24 10 71 63 70 33 30 30 34 71 63 70 16 22 22 22 58 50 50 50 50 57 18 22 21 22 14 19 58 50 50 50 57 21 23 71 63 70 20 23 33 30 30 30 30 30
30 30 30 30 30 30 34 20 23 17 23 22 14 69 69 69 67 63 70 33 30 30 34 71 63 70 23 16 15 21 58 50 50 50 50 57 24 20 22 23 23 13 58 50 50 50 57 22 24 71 63 70 21 24 33 30 30 30 30 30
30 30 30 30 30 30 34 23 23 19 23 20 71 63 63 63 63 63 70 33 30 30 34 71 63 66 69 14 17 22 58 50 50 50 50 57 24 22 23 22 24 11 58 50 50 50 57 22 20 71 63 70 22 20 33 30 30 30 30 30
30 30 30 30 30 30 34 23 23 16 22 24 13 68 68 68 65 63 70 33 30 30 34 71 63 63 63 70 15 23 58 50 50 50 50 57 10 23 23 23 21 12 58 50 50 50 57 21 23 71 63 70 23 20 33 30 30 30 30 30
30 30 30 30 30 30 34 23 16 17 23 22 22 22 23 22 71 63 70 33 30 30 34 71 63 64 68 15 22 20 58 50 50 50 50 57 17 10 23 20 24 11 58 50 50 50 57 22 21 71 63 70 21 18 33 30 30 30 30 30
30 30 30 30 30 30 34 24 15 15 15 24 22 22 23 22 71 63 70 33 30 30 34 71 63 70 22 25 24 24 58 50 50 50 50 57 24 13 20 21 20 23 58 50 50 50 57 24 23 71 63 70 21 17 33 30 30 30 30 30
30 30 30 30 30 30 34 24 19 23 16 15 24 22 22 14 71 63 70 33 30 30 34 71 63 70 22 20 23 21 58 50 50 50 50 57 22 16 24 23 23 24 58 50 50 50 57 22 24 71 63 70 23 19 33 30 30 30 30 30
30 30 30 30 30 30 34 22 18 20 22 23 22 24 22 21 71 63 70 33 30 30 34 71 63 70 23 22 24 23 58 50 50 50 50 57 23 15 13 18 24 20 58 50 50 50 57 22 24 71 63 70 22 23 33 30 30 30 30 30
30 30 30 30 30 30 34 22 17 23 24 24 22 23 24 23 13 68 11 33 30 30 34 25 68 17 20 23 22 24 58 50 50 50 50 57 24 23 24 12 11 23 58 50 50 50 57 20 23 71 63 70 21 24 33 30 30 30 30 30
30 30 30 30 30 30 34 22 16 17 24 24 24 14 23 14 11 12 24 41 32 32 42 16 18 23 22 24 22 23 58 50 50 50 50 57 24 24 22 23 14 14 58 50 50 50 57 22 24 71 63 70 21 20 33 30 30 30 30 30
30 30 30 30 30 30 34 20 18 14 21 24 24 14 14 16 14 15 18 20 23 24 18 17 23 20 24 23 21 23 58 50 50 50 50 57 19 23 23 24 23 18 58 50 50 50 57 22 21 71 63 70 24 21 33 30 30 30 30 30
30 30 30 30 30 30 34 23 24 14 23 22 11 59 56 56 56 56 56 56 56 56 56 56 56 56 56 56 56 56 54 50 50 50 50 53 56 56 56 56 56 56 54 50 50 50 57 20 23 71 63 70 23 24 33 30 30 30 30 30
30 30 30 30 30 30 34 24 24 11 22 22 18 58 50 50 50 50 50 50 50 50 50 50 50 50 50 50 50 50 50 50 50 50 50 50 50 50 50 50 50 50 50 50 50 50 57 22 24 71 63 70 24 23 33 30 30 30 30 30
30 30 30 30 30 30 34 20 21 10 24 20 15 58 50 50 50 50 50 50 50 50 50 50 50 50 50 50 50 50 50 50 50 50 50 50 50 50 50 50 50 50 50 50 50 50 57 24 15 71 63 70 23 39 38 30 30 30 30 30
30 30 30 30 30 30 34 22 23 13 22 23 12 58 50 50 50 50 50 50 50 50 50 50 50 50 50 50 50 50 50 50 50 50 50 50 50 50 50 50 50 50 50 50 50 50 57 17 16 71 63 70 20 33 30 30 30 30 30 30
30 30 30 30 30 30 34 23 23 15 23 22 17 58 50 50 50 51 55 55 55 55 55 55 55 52 50 50 51 55 55 52 50 50 50 51 55 55 55 55 55 55 55 55 55 55 62 24 20 71 63 70 21 33 30 30 30 30 30 30
30 30 30 30 30 30 34 22 14 12 20 22 22 58 50 50 50 57 21 24 22 24 20 23 14 58 50 50 57 21 18 58 50 50 50 57 11 12 11 12 13 11 17 13 12 13 11 22 21 71 63 70 24 33 30 30 30 30 30 30
30 30 30 30 30 30 34 20 16 20 22 25 22 58 50 50 50 57 23 39 31 31 40 24 15 58 50 50 57 24 23 58 50 50 50 57 17 24 23 18 19 18 19 18 19 18 23 23 24 71 63 70 24 33 30 30 30 30 30 30
30 30 30 30 30 30 34 20 15 21 22 21 24 58 50 50 50 57 20 33 30 30 34 20 14 58 50 50 57 20 21 58 50 50 50 57 23 22 22 20 18 19 18 19 18 20 22 21 24 71 63 70 23 33 30 30 30 30 30 30
30 30 30 30 35 32 42 22 17 24 22 24 20 58 50 50 50 57 23 33 30 30 34 23 14 58 50 50 57 23 22 58 50 50 50 57 24 24 21 22 21 22 21 24 22 23 22 22 14 67 63 70 21 33 30 30 30 30 30 30
30 30 30 30 34 23 16 23 12 23 22 22 24 58 50 50 50 57 23 33 30 30 34 21 15 58 50 50 57 21 20 58 50 50 50 57 24 22 23 22 23 22 24 21 21 24 23 24 71 63 63 70 24 41 36 30 30 30 30 30
30 30 30 30 37 31 40 21 12 18 22 24 24 58 50 50 50 57 20 33 30 30 34 22 16 58 50 50 57 22 23 58 50 50 50 57 24 24 22 21 23 24 23 24 24 22 24 23 71 63 64 11 22 14 33 30 30 30 30 30
30 30 30 30 30 30 34 23 21 12 22 20 17 58 50 50 50 57 15 33 30 30 34 22 14 58 50 50 57 20 21 58 50 50 50 57 23 22 23 22 24 22 24 23 21 15 20 21 15 68 12 24 20 14 33 30 30 30 30 30
30 30 30 30 30 30 34 24 20 13 22 23 15 58 50 50 50 57 17 33 30 30 34 17 14 58 50 50 57 24 22 58 50 50 50 57 19 22 21 22 22 22 22 24 16 13 23 22 16 14 17 23 21 14 33 30 30 30 30 30
30 30 30 30 30 30 34 24 24 11 22 20 23 58 50 50 50 57 16 33 30 30 34 16 14 58 50 50 57 21 20 58 50 50 50 57 13 18 23 21 24 25 22 23 20 21 24 22 17 15 16 23 20 20 33 30 30 30 30 30
30 30 30 30 35 32 42 23 22 14 22 17 23 58 50 50 50 57 15 33 30 30 34 24 14 58 50 50 57 22 23 58 50 50 50 57 19 19 22 23 23 17 24 22 24 24 22 23 24 10 22 24 23 21 33 30 30 30 30 30
30 30 30 30 34 20 21 20 12 11 22 22 22 58 50 50 50 57 14 33 30 30 34 23 14 58 50 50 57 20 21 58 50 50 50 57 12 18 24 22 24 23 24 22 18 22 20 18 11 14 12 14 24 22 33 30 30 30 30 30
30 30 30 30 34 20 24 21 11 22 22 23 14 58 50 50 50 57 23 33 30 30 34 15 15 58 50 50 57 22 24 58 50 50 50 57 19 19 23 23 18 20 23 23 10 24 22 13 12 13 14 23 23 22 33 30 30 30 30 30
30 30 30 30 34 22 22 24 12 21 23 23 18 58 50 50 50 57 20 33 30 30 34 13 16 58 50 50 57 21 20 58 50 50 50 57 18 24 22 21 16 20 24 22 21 22 24 21 15 13 14 23 24 22 33 30 30 30 30 30
30 30 30 30 34 23 22 24 10 23 24 20 18 58 50 50 50 57 23 33 30 30 34 23 14 58 50 50 57 24 22 58 50 50 50 57 19 24 23 24 25 24 24 20 24 24 17 16 11 12 24 22 20 21 33 30 30 30 30 30
30 30 30 30 34 21 24 20 10 15 17 22 23 61 55 55 55 62 22 33 30 30 34 22 17 58 50 50 57 20 21 58 50 50 50 57 18 21 22 24 20 23 23 23 22 13 24 19 13 15 21 24 21 20 33 30 30 30 30 30
30 30 30 30 34 23 21 23 11 14 21 23 21 23 22 22 21 13 15 33 30 30 34 19 14 58 50 50 57 22 24 58 50 50 50 57 20 24 23 22 22 21 17 20 23 15 17 18 11 14 22 23 24 18 33 30 30 30 30 30
30 30 30 30 34 24 20 24 14 22 24 22 22 23 23 20 23 21 17 33 30 30 34 11 24 61 55 55 62 18 23 61 55 55 55 62 23 22 24 23 22 23 16 13 24 14 22 20 14 15 19 24 22 18 33 30 30 30 30 30
30 30 30 30 34 24 24 21 10 12 23 21 24 21 23 24 22 23 12 33 30 30 34 16 23 24 21 23 12 14 15 14 22 24 21 24 20 23 24 23 24 12 15 13 17 15 26 26 26 10 26 25 24 19 33 30 30 30 30 30
30 30 30 30 34 23 22 21 22 14 23 23 24 24 23 22 22 12 16 33 30 30 34 17 15 22 23 20 22 23 24 21 23 24 21 23 11 24 21 20 22 14 17 23 21 22 26 17 10 14 18 22 26 15 33 30 30 30 30 30
30 30 30 30 34 24 22 21 25 14 18 21 22 22 24 22 24 17 24 33 30 30 34 22 16 15 21 24 24 13 21 22 20 24 23 20 14 24 22 23 12 16 24 23 24 21 24 10 10 10 15 20 24 21 33 30 30 30 30 30
30 30 30 30 37 40 21 21 24 24 15 20 24 23 22 22 13 11 20 33 30 30 34 22 23 13 15 25 20 24 12 24 23 23 20 24 22 22 20 22 13 25 20 22 21 24 15 15 14 10 27 15 20 26 33 30 30 30 30 30
30 30 30 30 30 34 21 20 22 23 17 15 15 22 20 23 14 24 24 33 30 30 34 23 22 24 14 19 24 15 24 21 23 24 24 24 22 20 23 16 15 23 23 23 24 23 26 24 18 10 10 21 26 26 33 30 30 30 30 30
30 30 30 30 30 37 31 40 22 22 22 23 16 15 23 21 10 20 24 33 30 30 34 20 23 13 14 14 10 23 22 22 14 15 16 13 23 24 24 17 24 24 24 14 15 20 26 26 26 26 26 24 25 20 33 30 30 30 30 30
30 30 30 30 30 30 30 34 22 22 15 14 17 14 15 14 11 23 15 33 30 30 34 24 20 23 24 10 11 15 16 15 13 19 12 11 12 10 10 12 10 10 13 10 10 15 14 16 17 24 25 22 22 23 33 30 30 30 30 30
30 30 30 30 30 30 30 37 31 31 31 31 31 31 31 31 31 31 31 38 30 30 37 31 31 31 31 31 31 31 31 31 31 31 31 31 31 31 31 31 31 31 31 31 31 31 31 40 21 24 24 39 31 31 38 30 30 30 30 30
30 30 30 30 30 30 30 30 30 30 30 30 30 30 30 30 30 30 30 30 30 30 30 30 30 30 30 30 30 30 30 30 30 30 30 30 30 30 30 30 30 30 30 30 30 30 30 37 31 31 31 38 30 30 30 30 30 30 30 30
30 30 30 30 30 30 30 30 30 30 30 30 30 30 30 30 30 30 30 30 30 30 30 30 30 30 30 30 30 30 30 30 30 30 30 30 30 30 30 30 30 30 30 30 30 30 30 30 30 30 30 30 30 30 30 30 30 30 30 30
30 30 30 30 30 30 30 30 30 30 30 30 30 30 30 30 30 30 30 30 30 30 30 30 30 30 30 30 30 30 30 30 30 30 30 30 30 30 30 30 30 30 30 30 30 30 30 30 30 30 30 30 30 30 30 30 30 30 30 30
30 30 30 30 30 30 30 30 30 30 30 30 30 30 30 30 30 30 30 30 30 30 30 30 30 30 30 30 30 30 30 30 30 30 30 30 30 30 30 30 30 30 30 30 30 30 30 30 30 30 30 30 30 30 30 30 30 30 30 30
30 30 30 30 30 30 30 30 30 30 30 30 30 30 30 30 30 30 30 30 30 30 30 30 30 30 30 30 30 30 30 30 30 30 30 30 30 30 30 30 30 30 30 30 30 30 30 30 30 30 30 30 30 30 30 30 30 30 30 30
30 30 30 30 30 30 30 30 30 30 30 30 30 30 30 30 30 30 30 30 30 30 30 30 30 30 30 30 30 30 30 30 30 30 30 30 30 30 30 30 30 30 30 30 30 30 30 30 30 30 30 30 30 30 30 30 30 30 30 30
