30 30 30 30 30 30 30 30 30 30 30 30 30 30 30 30 30 30 30 30 30 30 30 30 30 30 30 30 30 30 30 30 30 30 30 30 30 30 30 30 30 30 30 30 30 30 30 30 30 30 30 30 30 30 30 30 30 30 30 30
30 30 30 30 30 30 30 30 30 30 30 30 30 30 30 30 30 30 30 30 30 30 30 30 30 30 30 30 30 30 30 30 30 30 30 30 30 30 30 30 30 30 30 30 30 30 30 30 30 30 30 30 30 30 30 30 30 30 30 30
30 30 30 30 30 30 30 30 30 30 30 30 30 30 30 30 30 30 30 30 30 30 30 30 30 30 30 30 30 30 30 30 30 30 30 30 30 30 30 30 30 30 30 30 30 30 30 30 30 30 30 30 30 30 30 30 30 30 30 30
30 30 30 30 30 30 30 30 35 32 32 32 32 32 32 32 32 36 30 30 30 30 30 35 32 32 32 32 32 32 32 32 32 32 32 32 32 32 32 32 32 32 32 32 32 32 32 32 32 32 32 32 32 32 36 30 30 30 30 30
30 30 30 30 30 30 35 32 42 22 24 23 17 19 24 12 11 20 36 30 30 30 35 23 20 21 22 22 22 23 24 14 25 20 23 14 17 23 23 10 23 20 21 20 23 21 20 23 24 24 22 24 21 19 33 30 30 30 30 30
30 30 30 30 30 30 34 23 20 24 22 21 22 20 23 20 24 22 23 36 30 30 34 24 22 21 22 20 22 24 24 23 20 24 23 24 24 24 20 20 22 21 21 22 24 24 24 24 20 22 20 23 24 20 33 30 30 30 30 30
30 30 30 30 30 30 34 21 21 23 15 12 21 23 23 23 10 69 10 33 30 30 34 18 10 13 11 10 10 10 10 10 10 10 10 10 10 10 10 20 20 20 10 10 10 10 10 10 10 10 10 20 22 23 33 30 30 30 30 30
30 30 30 30 30 30 34 19 21 12 13 13 17 20 21 23 71 63 70 33 30 30 34 10 69 10 10 10 10 10 59 56 56 56 56 60 10 10 10 10 10 10 10 10 10 10 10 10 10 10 10 10 23 10 33 30 30 30 30 30
30 30 30 30 30 30 34 23 21 19 14 12 12 16 20 17 71 63 70 33 30 30 34 71 63 70 10 10 23 14 58 50 50 50 50 57 10 10 10 10 10 10 10 10 10 10 10 10 10 10 10 10 20 10 33 30 30 30 30 30
30 30 30 30 30 30 34 20 20 17 11 13 19 18 23 19 71 63 70 33 30 30 34 71 63 70 12 22 22 23 58 50 50 50 50 57 10 10 10 10 10 10 10 10 10 10 10 10 10 10 10 10 20 20 33 30 30 30 30 30
30 30 30 30 30 30 34 21 20 21 17 19 18 16 21 22 71 63 70 33 30 30 34 71 63 70 22 17 23 24 58 50 50 50 50 57 10 10 10 10 10 10 10 10 10 10 10 10 10 10 10 10 22 16 33 30 30 30 30 30
30 30 30 30 30 30 34 18 22 22 21 23 10 24 23 22 71 63 70 33 30 30 34 71 63 70 21 22 25 11 58 50 50 50 50 57 10 10 10 10 10 10 10 10 10 10 10 10 10 10 10 10 22 17 33 30 30 30 30 30
30 30 30 30 30 30 34 22 23 22 22 22 10 23 24 10 71 63 70 33 30 30 34 71 63 70 16 22 22 22 58 50 50 50 50 57 10 10 10 10 10 10 10 10 10 10 10 10 10 10 10 10 20 23 33 30 30 30 30 30
30 30 30 30 30 30 34 20 23 15 23 12 69 69 69 69 67 63 70 33 30 30 34 71 63 70 23 10 10 21 58 50 50 50 50 57 10 10 10 10 10 10 10 10 10 10 10 10 10 10 10 10 21 24 33 30 30 30 30 30
30 30 30 30 30 30 34 23 23 19 21 71 63 63 63 63 63 63 70 33 30 30 34 71 63 66 69 10 10 10 58 50 50 50 50 57 10 10 10 10 10 10 10 10 10 10 10 10 10 10 10 10 22 20 33 30 30 30 30 30
30 30 30 30 30 30 34 23 23 16 22 24 68 68 68 68 65 63 70 33 30 30 34 71 63 63 63 70 10 10 58 50 50 50 50 57 10 10 10 10 10 10 10 10 10 10 10 10 10 10 10 10 23 20 33 30 30 30 30 30
30 30 30 30 30 30 34 23 16 17 23 22 22 22 23 22 71 63 70 33 30 30 34 71 63 64 68 10 10 10 58 50 50 50 50 57 10 10 10 10 10 10 10 10 10 10 10 10 10 10 10 10 21 18 33 30 30 30 30 30
30 30 30 30 30 30 34 24 15 15 15 24 22 22 23 22 71 63 70 33 30 30 34 71 63 70 22 22 10 10 58 50 50 50 50 57 60 60 60 60 60 60 10 10 10 10 10 10 10 10 10 10 21 17 33 30 30 30 30 30
30 30 30 30 30 30 34 24 19 23 16 15 24 22 22 14 71 63 70 33 30 30 34 71 63 70 22 21 10 10 58 50 50 50 50 57 50 50 50 50 50 50 10 10 10 10 10 10 10 10 10 10 23 19 33 30 30 30 30 30
30 30 30 30 30 30 34 22 18 20 22 23 22 24 22 21 71 63 70 33 30 30 34 71 63 70 17 24 10 10 58 50 50 50 50 57 50 50 50 50 50 50 10 10 10 10 10 10 10 10 10 10 22 23 33 30 30 30 30 30
30 30 30 30 30 30 34 22 17 23 24 24 22 23 24 23 10 68 11 33 30 30 34 71 63 66 69 69 10 10 58 50 50 50 50 57 59 59 59 59 59 59 10 10 10 10 10 10 10 10 10 10 21 24 33 30 30 30 30 30
30 30 30 30 30 30 34 22 16 17 24 24 24 14 23 14 10 10 24 41 32 32 42 71 63 63 63 63 70 10 58 50 50 50 50 57 10 10 10 10 10 10 10 10 10 10 10 10 10 10 10 10 21 20 33 30 30 30 30 30
30 30 30 30 30 30 34 20 10 10 10 24 24 14 14 14 10 10 10 19 18 19 18 10 68 68 68 68 10 10 58 50 50 50 50 57 10 10 10 10 10 10 10 10 10 10 10 10 10 10 10 10 24 21 33 30 30 30 30 30
30 30 30 30 30 30 34 23 24 10 10 10 10 59 56 56 56 56 56 56 56 56 56 56 56 56 56 56 56 56 54 50 50 50 50 57 10 10 10 10 10 10 10 10 10 10 10 10 10 10 10 10 23 24 33 30 30 30 30 30
30 30 30 30 30 30 34 24 24 10 10 10 10 58 50 50 50 50 50 50 50 50 50 50 50 50 50 50 50 50 50 50 50 50 50 57 10 10 10 10 10 10 10 10 10 10 10 10 10 10 10 10 10 23 24 33 30 30 30 30
30 30 30 30 30 30 34 20 21 10 10 10 10 58 50 50 50 50 50 50 50 50 50 50 50 50 50 50 50 50 50 50 50 50 50 57 10 10 10 10 10 10 10 10 10 10 10 10 10 10 10 10 23 39 38 30 30 30 30 30
30 30 30 30 30 30 34 22 23 10 10 10 10 58 50 50 50 50 50 50 50 50 50 50 50 50 50 50 50 50 50 50 50 50 50 57 10 10 10 10 10 10 10 10 10 10 10 10 10 10 10 10 20 33 30 30 30 30 30 30
30 30 30 30 30 30 34 23 23 10 10 10 10 58 50 50 50 51 55 55 55 55 55 55 55 55 55 55 55 55 55 55 55 55 55 62 10 10 10 10 10 10 10 10 10 10 10 10 10 10 10 10 21 33 30 30 30 30 30 30
30 30 30 30 30 30 34 22 10 10 10 10 10 58 50 50 50 57 10 10 10 11 10 10 10 10 10 10 10 10 10 10 10 10 10 10 10 10 10 10 10 10 10 10 10 10 10 10 10 10 10 10 24 33 30 30 30 30 30 30
30 30 30 30 30 30 34 20 21 20 10 10 10 58 50 50 50 57 10 39 31 31 40 10 10 10 10 10 10 10 10 10 10 10 10 10 10 10 10 10 10 10 10 10 10 10 10 10 10 10 10 10 24 33 30 30 30 30 30 30
30 30 30 30 30 30 34 20 24 21 10 10 10 58 50 50 50 57 10 33 30 30 34 10 10 10 10 10 10 10 10 10 10 10 10 10 10 10 10 10 10 10 10 10 10 10 10 10 10 10 10 10 23 33 30 30 30 30 30 30
30 30 30 30 35 32 42 22 17 24 10 10 10 58 50 50 50 57 10 33 30 30 34 10 10 10 10 10 10 10 10 10 10 10 10 10 10 10 10 10 10 10 10 10 10 10 10 10 10 10 10 10 21 33 30 30 30 30 30 30
30 30 30 30 34 23 16 23 12 10 10 10 10 58 50 50 50 57 10 33 30 30 34 10 10 10 10 10 10 10 10 10 10 10 10 10 10 10 10 10 10 10 10 10 10 10 10 10 10 10 10 10 24 41 36 30 30 30 30 30
30 30 30 30 37 31 40 21 12 18 10 10 10 58 50 50 50 57 10 33 30 30 34 10 10 10 10 10 10 10 10 10 10 10 10 10 10 10 10 10 10 10 10 10 10 10 10 10 10 10 10 10 22 14 33 30 30 30 30 30
30 30 30 30 30 30 34 23 21 12 10 10 10 58 50 50 50 57 10 33 30 30 34 10 10 10 10 10 10 10 10 10 10 10 10 10 10 10 10 10 10 10 10 10 10 10 10 10 10 10 10 10 20 14 33 30 30 30 30 30
30 30 30 30 30 30 34 24 20 13 10 10 10 58 50 50 50 57 10 33 30 30 34 10 10 10 10 10 10 10 10 10 10 10 10 10 10 10 10 10 10 10 10 10 10 10 10 10 10 10 10 10 21 14 33 30 30 30 30 30
30 30 30 30 30 30 34 24 24 11 10 10 10 58 50 50 50 57 10 33 30 30 34 10 10 10 10 10 10 10 10 10 10 10 10 10 10 10 10 10 10 10 10 10 10 10 10 10 10 10 10 10 20 20 33 30 30 30 30 30
30 30 30 30 35 32 42 23 22 14 10 10 10 58 50 50 50 57 10 33 30 30 34 10 10 10 10 10 10 10 10 10 10 10 10 10 10 10 10 10 10 10 10 10 10 10 10 10 10 10 10 10 23 21 33 30 30 30 30 30
30 30 30 30 34 20 21 20 10 10 10 10 10 58 50 50 50 57 10 33 30 30 34 10 10 10 10 10 10 10 10 10 10 10 10 10 10 10 10 10 10 10 10 10 10 10 10 10 10 10 10 10 24 22 33 30 30 30 30 30
30 30 30 30 34 20 24 21 10 10 10 10 10 58 50 50 50 57 10 33 30 30 34 10 10 10 10 10 10 10 10 10 10 10 10 10 10 10 10 10 10 10 10 10 10 10 10 10 10 10 10 10 23 22 33 30 30 30 30 30
30 30 30 30 34 22 22 24 10 59 56 56 56 54 50 50 50 57 10 33 30 30 34 10 10 10 10 10 10 10 10 10 10 10 10 10 10 10 10 10 10 10 10 10 10 10 10 10 10 10 10 10 24 22 33 30 30 30 30 30
30 30 30 30 34 23 22 24 10 58 50 50 50 50 50 50 50 57 10 33 30 30 34 10 10 10 10 10 10 10 10 10 10 10 10 10 10 10 10 10 10 10 10 10 10 10 10 10 10 10 10 10 20 21 33 30 30 30 30 30
30 30 30 30 34 21 24 20 10 58 50 50 50 50 50 50 50 57 10 33 30 30 34 10 10 10 10 10 10 10 10 10 10 10 10 10 10 10 10 10 10 10 10 10 10 10 10 10 10 10 10 10 21 20 33 30 30 30 30 30
30 30 30 30 34 23 21 23 10 58 50 50 50 50 50 50 50 57 10 33 30 30 34 10 10 10 10 10 10 10 10 10 10 10 10 10 10 10 10 10 10 10 10 10 10 10 10 10 10 10 10 10 24 18 33 30 30 30 30 30
30 30 30 30 34 24 20 24 10 58 50 50 50 50 50 50 50 57 10 33 30 30 34 10 10 10 10 10 10 10 10 10 10 10 10 10 10 10 10 10 10 10 10 10 10 10 10 10 10 10 10 10 22 18 33 30 30 30 30 30
30 30 30 30 34 24 24 21 10 58 50 50 50 50 50 50 50 57 10 33 30 30 34 10 10 10 10 10 10 10 10 10 10 10 10 10 10 10 10 10 10 10 10 10 10 10 10 10 10 10 10 10 22 19 33 30 30 30 30 30
30 30 30 30 34 23 22 21 10 58 50 50 50 50 50 50 50 57 10 33 30 30 34 10 10 10 10 10 10 10 10 10 10 10 10 10 10 10 10 10 10 10 10 10 10 10 10 10 10 10 10 10 24 15 33 30 30 30 30 30
30 30 30 30 34 24 22 21 10 58 50 50 50 50 50 50 50 57 10 33 30 30 34 10 10 10 10 10 10 10 10 10 10 10 10 10 10 10 10 10 10 10 10 10 10 10 10 10 10 10 10 10 23 21 33 30 30 30 30 30
30 30 30 30 37 40 21 21 10 61 55 55 55 55 55 55 55 62 10 33 30 30 34 10 10 10 10 10 10 10 10 10 10 10 10 10 10 10 10 10 10 10 10 10 10 10 10 10 10 10 10 10 24 24 33 30 30 30 30 30
30 30 30 30 30 34 21 20 10 10 10 10 10 10 10 10 10 10 10 33 30 30 34 10 10 10 10 10 10 10 10 10 10 10 10 10 10 10 10 10 10 10 10 10 10 10 10 10 10 10 10 10 20 24 33 30 30 30 30 30
30 30 30 30 30 37 31 40 10 10 10 10 10 10 10 10 10 10 10 33 30 30 34 10 10 10 10 10 10 10 10 10 10 10 10 10 10 10 10 10 10 10 10 10 10 10 10 10 10 10 10 20 23 20 33 30 30 30 30 30
30 30 30 30 30 30 30 34 10 10 10 10 10 10 10 10 10 10 10 33 30 30 34 10 10 10 10 10 10 10 10 10 10 10 10 10 10 10 10 10 10 10 10 10 10 10 10 10 10 10 10 22 22 23 33 30 30 30 30 30
30 30 30 30 30 30 30 37 31 31 31 31 31 31 31 31 31 31 31 38 30 30 37 31 31 31 31 31 31 31 31 31 31 31 31 31 31 31 31 31 31 31 31 31 31 31 31 31 31 31 31 31 31 31 38 30 30 30 30 30
30 30 30 30 30 30 30 30 30 30 30 30 30 30 30 30 30 30 30 30 30 30 30 30 30 30 30 30 30 30 30 30 30 30 30 30 30 30 30 30 30 30 30 30 30 30 30 30 30 30 30 30 30 30 30 30 30 30 30 30
30 30 30 30 30 30 30 30 30 30 30 30 30 30 30 30 30 30 30 30 30 30 30 30 30 30 30 30 30 30 30 30 30 30 30 30 30 30 30 30 30 30 30 30 30 30 30 30 30 30 30 30 30 30 30 30 30 30 30 30
30 30 30 30 30 30 30 30 30 30 30 30 30 30 30 30 30 30 30 30 30 30 30 30 30 30 30 30 30 30 30 30 30 30 30 30 30 30 30 30 30 30 30 30 30 30 30 30 30 30 30 30 30 30 30 30 30 30 30 30
30 30 30 30 30 30 30 30 30 30 30 30 30 30 30 30 30 30 30 30 30 30 30 30 30 30 30 30 30 30 30 30 30 30 30 30 30 30 30 30 30 30 30 30 30 30 30 30 30 30 30 30 30 30 30 30 30 30 30 30
30 30 30 30 30 30 30 30 30 30 30 30 30 30 30 30 30 30 30 30 30 30 30 30 30 30 30 30 30 30 30 30 30 30 30 30 30 30 30 30 30 30 30 30 30 30 30 30 30 30 30 30 30 30 30 30 30 30 30 30
