1 8 3 7 6 4 4 4 6 7 9 9 2 0 0 2
1 8 3 6 0 4 4 4 6 7 7 9 2 7 0 2
1 8 3 7 6 4 4 4 6 7 7 8 2 6 0 2
1 9 3 7 6 4 4 4 6 6 6 8 2 6 7 2
1 8 3 6 4 4 4 4 4 4 4 7 2 8 7 2
1 6 3 4 4 4 4 4 4 4 4 7 2 8 8 2
1 8 3 4 4 4 4 4 4 4 4 7 2 7 6 2
1 8 3 4 4 4 4 4 4 4 4 2 2 2 2 2
1 9 3 7 6 4 4 4 6 6 0 7 6 6 7 2
1 8 3 6 0 4 4 4 6 7 0 0 0 0 6 2
1 6 3 7 6 4 4 4 6 7 0 8 0 0 7 2
1 0 3 0 6 4 4 4 7 6 0 0 9 0 6 2